21 21 31 29 32 21 22 21 21 21 21 21 21 21 21 21 21 21 21 21 21 21 21 21 21 21 21 21 21 21 21 21 21 21 21 21 21 21 21 21 21 21 21 21 21 21 21 21 21 21 
21 31 30 19 28 32 21 21 21 21 21 21 21 21 21 21 21 21 21 21 21 21 21 21 21 21 21 21 21 21 21 21 21 21 21 21 21 21 21 21 21 21 21 21 21 21 21 21 21 21 
21 27 19 19 19 26 21 21 21 21 21 21 21 21 21 21 21 21 21 21 21 21 21 21 21 21 21 21 21 21 21 21 21 21 21 21 21 21 21 21 21 21 21 21 21 21 21 21 21 21 
21 27 19 04 19 26 21 21 21 21 21 21 21 21 21 21 21 21 21 21 21 21 22 21 21 21 21 21 21 21 21 21 21 21 21 21 21 21 21 21 21 21 21 21 21 21 22 21 21 21 
21 27 18 01 18 26 22 21 21 21 21 21 21 21 21 21 21 21 21 21 21 21 21 21 21 21 21 21 22 21 21 21 21 21 22 21 21 21 21 21 21 21 21 21 21 21 21 21 21 21 
21 33 25 01 23 34 21 21 21 21 21 21 21 21 21 21 21 21 21 21 22 21 31 29 29 29 29 29 29 29 29 29 29 29 29 32 21 21 21 21 21 21 21 21 21 21 21 21 21 21 
22 21 27 01 26 21 21 21 21 21 21 21 21 31 29 29 29 29 29 29 29 29 30 14 12 12 12 12 12 12 12 12 12 12 15 28 32 21 21 21 21 21 21 21 21 21 21 21 21 21 
21 21 33 24 34 31 32 21 21 21 21 22 31 30 19 19 19 19 19 19 19 19 19 10 05 05 05 05 05 05 05 05 05 05 09 02 28 29 32 21 21 22 21 21 21 21 21 21 21 21 
21 21 21 21 21 33 34 21 21 21 21 31 30 19 19 19 19 19 19 19 19 19 19 10 05 06 07 07 07 07 07 07 08 05 09 03 02 02 28 32 21 21 21 21 21 21 21 21 21 21 
21 21 22 21 21 21 21 21 21 21 31 30 19 19 19 19 19 19 19 19 19 19 19 10 05 09 23 24 24 24 24 25 10 05 09 19 19 03 02 28 32 21 21 21 21 21 21 21 21 21 
21 21 21 21 21 21 21 21 21 31 30 19 19 19 19 19 19 19 19 19 19 19 19 10 05 09 26 22 31 32 21 27 10 05 09 19 19 19 02 02 26 21 21 21 21 21 21 21 21 21 
21 21 21 21 21 21 21 21 21 27 19 19 19 19 19 19 19 19 19 19 19 19 19 10 05 09 26 21 33 34 21 27 10 05 09 19 19 19 02 02 28 32 21 22 21 21 21 21 21 21 
21 21 21 21 21 21 21 21 31 30 19 20 20 20 20 20 19 19 19 19 19 19 19 10 05 09 26 31 32 22 21 27 10 05 09 19 19 19 19 19 02 26 21 21 21 21 21 21 21 21 
21 21 21 21 21 21 21 31 30 19 19 20 00 00 00 20 19 19 19 19 19 19 19 10 05 09 26 33 34 21 21 27 10 05 09 19 19 19 19 19 19 26 21 21 21 21 21 21 21 21 
21 21 21 21 21 21 21 27 19 19 19 20 00 20 00 20 19 19 19 19 19 19 19 10 05 09 26 31 29 32 22 27 10 05 09 19 19 19 19 02 19 26 21 21 22 21 21 21 21 21 
21 21 21 21 21 21 21 27 19 19 19 20 00 20 00 20 19 19 19 19 19 19 19 10 05 09 28 30 35 28 29 30 10 05 09 19 19 19 19 19 19 26 21 21 21 21 21 21 21 21 
21 21 21 21 21 21 21 27 19 19 19 20 00 20 20 20 19 19 19 19 19 19 19 10 05 11 12 12 12 12 12 12 13 05 09 19 19 19 19 19 19 26 22 21 21 21 21 21 21 21 
21 21 21 21 21 21 21 33 25 19 19 02 02 03 19 19 19 19 19 19 19 19 19 10 05 05 05 05 05 05 05 05 05 05 09 19 19 19 19 19 19 26 21 21 21 21 21 21 21 21 
21 21 21 21 21 21 21 22 27 19 19 03 02 02 19 19 19 19 19 19 19 19 19 16 07 07 07 08 05 06 07 07 07 07 17 19 19 19 19 19 19 26 21 21 21 21 21 21 21 21
21 21 21 21 21 21 21 31 30 19 19 19 02 19 19 19 19 19 19 19 19 19 19 19 02 19 19 10 05 09 19 19 19 19 19 19 19 19 19 02 19 26 21 21 21 21 21 21 21 21 
21 21 21 21 21 21 21 27 19 19 19 19 02 19 19 19 19 19 19 19 19 19 19 19 19 19 19 10 05 09 19 02 19 19 19 19 19 02 19 02 19 26 21 21 21 21 21 21 21 21 
21 21 21 21 21 21 21 27 19 19 19 19 02 19 19 19 19 19 19 19 19 19 19 19 19 19 19 10 05 09 19 02 19 19 19 19 19 19 19 19 02 26 21 21 21 21 21 21 21 21 
21 21 21 21 21 21 21 27 19 19 02 02 03 19 19 19 19 19 19 19 19 19 19 19 19 19 19 10 05 09 19 19 19 19 02 19 19 19 19 02 02 26 21 21 21 21 21 21 21 21 
21 21 21 21 21 21 22 27 19 19 02 19 19 19 19 19 19 19 19 19 19 19 19 02 19 19 19 10 05 09 19 19 02 19 19 19 02 02 03 02 02 26 21 22 21 21 21 21 21 21 
21 21 21 21 21 21 21 27 19 19 02 19 19 19 19 19 19 19 19 19 02 02 02 02 02 19 02 10 05 09 19 19 02 02 02 02 02 02 02 02 02 26 21 21 21 21 21 21 21 21 
21 21 21 21 21 21 21 27 19 19 02 02 03 02 19 19 19 19 19 19 02 02 02 02 02 02 02 10 05 09 19 19 02 02 02 03 02 19 19 03 02 26 21 21 21 21 21 21 21 21 
21 21 21 21 21 21 21 27 19 19 19 19 19 02 02 02 03 02 02 02 02 03 19 03 02 02 02 10 05 09 02 02 03 02 02 02 19 02 02 02 02 26 21 21 21 21 21 21 21 21 
21 21 21 21 21 21 21 33 25 19 19 19 19 19 19 19 19 19 19 19 02 02 02 02 03 02 02 10 05 09 14 12 12 12 12 12 12 12 12 15 02 26 22 21 21 21 21 21 21 21 
21 21 21 21 21 21 21 22 27 19 19 19 19 19 19 19 19 19 19 19 02 02 02 02 02 03 14 13 05 11 13 05 05 05 05 05 05 05 05 09 02 26 21 21 21 21 21 21 21 21 
21 21 21 21 21 21 21 21 27 19 19 19 19 19 19 19 19 19 19 19 19 19 02 02 02 14 13 05 05 05 05 06 07 07 07 07 07 08 05 09 02 26 21 21 21 21 21 21 21 21 
21 21 21 21 21 21 21 31 30 19 19 19 19 19 19 19 19 19 19 19 19 19 19 03 14 13 05 05 06 07 07 02 02 19 19 19 14 13 05 09 03 26 21 21 21 21 21 21 21 21 
21 21 21 21 21 21 21 27 19 19 19 19 19 19 19 19 19 19 02 02 02 02 02 02 10 05 05 06 02 02 19 19 19 02 02 02 10 05 05 09 02 26 21 21 21 21 21 21 21 21 
21 21 21 21 21 21 21 27 19 19 19 19 19 19 19 19 19 19 19 19 19 03 02 14 13 05 06 02 02 19 19 02 02 02 03 14 13 05 06 17 02 26 21 21 21 21 21 21 21 21 
21 21 21 21 21 21 21 33 24 25 02 02 19 19 19 19 19 19 19 02 19 02 02 10 05 05 02 02 19 19 02 02 02 02 02 10 05 05 09 02 02 26 21 22 21 21 21 21 21 21 
21 21 21 21 21 21 21 21 21 27 02 02 02 02 02 02 19 19 19 19 19 02 19 10 05 06 02 19 19 02 02 03 02 19 02 10 05 06 17 03 02 26 21 21 21 21 21 21 21 21 
21 21 21 21 21 21 22 21 21 27 02 03 02 02 02 03 02 19 02 02 19 19 02 10 05 09 02 19 02 02 02 02 19 19 14 13 05 19 02 02 02 26 21 21 21 21 21 21 21 21 
21 21 21 21 21 21 21 21 21 27 02 02 02 02 02 02 02 19 19 19 19 02 02 10 05 11 15 19 02 02 19 02 19 02 10 05 05 19 02 02 23 34 21 21 21 21 21 21 21 21 
21 21 21 21 21 21 21 21 21 27 02 02 19 02 02 03 02 02 03 02 02 02 02 10 05 05 09 19 02 02 02 19 14 12 13 05 06 19 02 02 26 21 21 21 21 21 21 21 21 21 
21 21 21 21 21 21 21 21 21 27 02 02 02 02 02 02 02 03 02 02 02 02 19 16 08 05 11 15 02 02 14 12 13 05 05 05 09 02 03 02 26 21 22 21 21 21 21 21 21 21 
21 21 21 21 21 21 21 21 22 27 02 02 02 02 02 02 02 19 19 19 19 19 19 02 10 05 05 11 15 14 13 05 05 05 06 07 17 02 02 02 26 21 21 21 21 21 21 21 21 21 
21 21 21 21 21 21 21 21 21 33 25 02 03 02 02 02 02 19 19 02 19 19 19 02 16 08 05 05 11 13 05 05 06 07 17 02 02 02 02 02 26 21 21 21 21 21 21 21 21 21 
21 21 21 21 21 21 21 21 21 21 33 25 02 19 02 19 19 19 19 19 19 02 19 19 19 16 08 05 05 05 05 06 17 02 02 02 02 02 02 23 34 21 21 21 21 21 21 21 21 21 
21 21 21 21 21 21 21 21 21 21 21 27 19 19 19 19 02 19 02 02 02 02 02 02 19 19 16 07 07 07 07 17 02 02 03 02 02 02 23 34 21 21 21 21 21 21 21 21 21 21 
21 21 22 21 21 21 21 21 21 21 21 27 19 19 19 19 19 19 02 19 02 02 02 02 02 02 02 02 02 02 03 02 02 02 02 23 24 24 34 21 22 21 21 21 21 21 21 21 21 21 
21 21 21 21 21 21 21 21 22 22 21 33 25 02 02 02 19 02 02 02 02 03 02 02 02 02 03 02 02 02 02 02 23 24 24 34 21 21 21 21 21 21 21 21 21 21 21 21 21 21 
21 21 21 21 21 21 21 21 21 21 21 21 33 24 25 02 02 02 02 02 02 02 02 02 02 02 02 02 02 02 23 24 34 21 21 21 22 21 21 21 21 21 21 21 21 21 22 21 21 21 
21 21 21 21 21 21 21 21 21 21 21 21 21 21 33 24 24 25 02 23 24 24 24 24 24 24 24 01 24 24 34 21 21 21 21 21 21 21 21 21 21 21 21 21 21 21 21 21 21 21 
21 21 21 21 21 21 21 21 21 21 21 21 21 21 21 31 32 27 03 26 21 21 21 22 21 31 29 01 32 21 21 22 21 21 21 21 21 21 21 21 21 21 21 21 21 21 21 21 21 21 
21 21 21 21 21 21 21 21 21 21 21 21 21 21 22 33 34 27 02 26 21 21 21 21 21 27 18 03 26 21 21 21 21 21 21 21 21 21 21 21 21 21 21 21 21 21 21 21 21 21 
21 21 21 21 21 21 21 21 21 21 21 21 21 21 21 21 21 33 24 34 21 22 21 21 21 33 24 24 34 21 21 21 21 21 21 21 21 21 21 21 21 21 21 21 21 21 21 21 21 21 
