19 19 19 19 19 19 19 19 19 19 19 19 19 19 19 19 19 19 19 19 19 19 19 19 19 19 19 19 19 19 19 19 19 19 19 19 02 19 19 02 19 19 19 19 19 19 19 19 19 19 
19 19 19 19 19 19 19 19 19 19 19 19 19 19 19 19 02 02 02 03 03 02 02 19 19 19 19 19 19 19 19 19 19 19 19 19 19 19 19 19 02 19 19 19 19 19 19 19 19 19 
19 19 19 02 19 19 19 19 19 19 19 19 19 19 02 02 03 03 03 03 03 02 19 19 19 19 19 19 19 19 19 19 19 19 19 19 19 19 19 19 19 19 19 19 19 19 19 19 19 19 
19 02 19 19 02 02 02 19 19 19 19 02 02 02 02 03 03 03 03 03 02 02 02 02 19 19 19 19 19 19 19 19 19 19 19 19 19 19 19 19 19 19 19 19 19 19 02 19 19 19 
19 19 19 19 19 19 19 19 19 02 02 02 02 02 02 02 02 02 02 02 02 02 02 02 02 02 02 02 02 02 02 02 02 02 19 19 19 19 19 19 19 19 19 02 02 02 19 19 19 19 
19 19 19 19 19 19 02 02 02 02 02 02 02 02 02 02 19 19 02 02 03 03 03 03 03 03 03 02 02 02 02 02 19 19 19 02 02 19 19 19 02 02 02 02 02 02 19 19 19 19 
19 19 19 19 19 19 02 02 02 02 19 19 03 03 02 02 02 02 02 02 03 02 02 02 02 02 03 02 02 02 02 19 19 02 02 19 19 19 02 02 02 02 02 02 02 02 19 19 19 19 
19 19 19 19 19 02 02 03 03 02 19 02 02 03 02 03 03 03 02 02 02 19 19 19 19 19 02 02 02 02 19 02 02 02 02 19 19 02 02 02 02 02 02 03 02 02 19 19 19 19 
19 19 19 19 19 02 02 03 03 02 19 02 02 03 02 02 19 19 19 19 19 02 02 02 02 19 19 02 02 02 02 02 02 02 02 02 02 02 02 02 03 02 02 03 03 02 19 02 19 19 
19 19 02 19 19 02 02 02 03 02 02 02 02 02 02 02 02 19 19 02 02 02 02 02 02 19 19 02 02 02 02 02 02 02 02 02 02 02 02 02 03 02 02 02 19 19 19 02 02 19 
19 19 19 19 19 02 02 02 03 02 19 02 02 02 02 02 02 19 19 19 19 19 02 02 02 19 02 02 02 02 19 19 19 19 02 02 02 02 02 02 02 02 02 19 19 02 02 02 02 19 
19 19 19 19 19 02 02 03 03 02 19 19 19 02 02 02 02 02 02 02 02 02 03 02 02 02 02 02 02 02 19 02 02 02 02 02 03 03 03 02 02 02 02 19 19 02 20 20 20 20 
19 02 19 19 19 02 02 03 02 02 02 02 02 14 12 12 12 12 12 12 12 12 12 12 12 12 12 15 02 03 02 19 19 02 02 02 02 02 02 02 02 02 19 19 19 02 20 20 20 20 
19 02 19 19 19 02 03 03 14 12 12 12 12 13 05 05 05 05 05 05 05 05 05 05 05 05 05 09 02 02 02 02 02 02 02 02 02 19 19 19 02 02 02 02 19 02 20 20 20 20 
19 19 19 19 02 02 03 02 10 05 05 05 05 05 05 06 07 07 07 07 07 07 07 07 07 07 07 17 02 02 02 02 02 02 02 02 19 19 02 02 02 02 02 19 19 02 20 20 20 20 
19 19 19 19 02 02 02 02 10 05 05 06 07 07 07 17 02 02 02 02 02 02 02 02 02 02 02 02 02 02 02 02 19 19 02 02 19 19 02 02 02 02 02 02 19 02 20 20 20 20 
19 19 19 19 02 02 02 02 10 05 05 09 02 02 02 02 02 02 02 02 02 02 02 02 02 02 02 02 02 02 02 19 19 02 02 19 02 19 02 02 02 19 19 19 19 02 20 20 20 20 
19 19 02 02 02 03 02 02 10 05 05 09 02 02 02 02 03 03 02 02 02 02 02 02 02 03 02 02 02 02 02 19 19 02 02 19 02 02 02 03 02 19 02 02 19 02 20 02 02 20 
02 19 19 02 03 03 02 02 10 05 05 09 02 02 03 03 03 02 23 24 24 24 25 02 02 03 02 02 02 02 19 19 19 02 02 19 02 02 02 02 02 19 02 02 02 02 02 19 03 20 
25 02 19 02 03 03 03 02 10 05 05 09 02 03 02 02 02 02 26 21 21 21 27 02 02 02 03 02 02 02 19 19 19 02 02 19 19 02 02 02 02 19 02 19 02 02 02 02 02 20 
33 25 02 02 02 02 03 03 10 05 05 09 02 03 02 02 02 23 34 21 21 31 30 02 02 02 02 02 02 02 19 19 19 02 02 02 19 19 02 19 02 02 02 02 02 02 20 02 02 20 
32 33 24 25 02 02 02 02 16 01 01 17 02 02 02 02 02 26 22 21 31 30 02 02 02 02 02 02 02 19 19 02 19 19 02 02 02 02 02 19 19 02 02 02 02 02 20 02 03 20 
28 32 22 27 02 02 02 02 02 01 01 02 02 02 02 02 02 26 21 21 33 25 02 02 02 02 02 03 02 19 19 19 19 19 02 03 02 02 02 02 02 02 02 02 02 02 20 02 02 20 
19 26 21 33 24 24 24 24 24 01 01 24 24 24 24 24 24 34 21 31 32 27 23 24 24 24 25 03 03 19 19 19 19 02 02 02 02 02 02 02 02 19 19 19 02 02 02 03 02 20 
19 28 29 29 29 29 29 29 29 01 01 29 29 29 29 29 29 32 21 33 34 27 26 21 21 22 27 02 02 02 19 02 02 02 19 02 02 19 02 03 03 02 02 02 02 02 02 02 02 20 
19 02 02 02 02 02 02 02 02 01 01 02 02 02 02 02 02 26 22 21 21 27 26 21 21 21 27 02 02 02 19 19 02 02 19 19 02 19 02 02 03 02 02 02 19 02 20 02 19 20 
19 02 19 19 02 02 02 02 14 01 01 15 02 02 02 02 02 28 29 29 29 30 28 29 29 29 30 02 02 02 19 19 02 02 02 19 19 19 02 02 02 02 19 19 19 02 20 20 20 20 
19 19 19 02 03 03 02 02 10 05 05 09 02 02 02 03 02 23 24 24 24 25 23 25 02 02 02 02 02 02 19 19 02 02 02 02 02 19 02 02 02 19 02 02 02 19 20 20 20 20 
19 19 02 02 03 03 02 02 10 05 05 09 02 03 03 02 02 26 25 03 26 27 26 27 02 02 02 19 19 19 19 02 02 02 02 02 19 19 02 02 19 19 02 02 19 19 20 20 20 20 
19 19 02 03 03 03 02 14 13 05 05 09 02 03 02 02 02 26 33 24 34 27 28 30 02 02 19 19 02 19 19 02 03 03 02 02 19 02 02 02 02 02 02 02 02 02 20 20 20 20 
19 19 03 03 02 14 12 13 05 05 05 09 02 02 02 02 02 28 29 29 29 30 02 02 02 02 19 02 19 02 19 02 02 02 02 02 02 02 02 02 19 02 02 02 02 02 20 20 20 20 
19 19 19 02 14 13 05 05 05 05 05 09 02 02 19 02 02 02 02 02 02 02 02 02 02 02 19 02 19 19 19 02 02 19 19 02 02 02 02 02 19 02 02 19 02 02 20 20 20 20 
19 14 12 12 13 05 05 05 05 05 06 17 02 02 02 19 02 02 02 02 02 02 02 02 02 02 19 19 02 02 02 02 02 19 19 02 02 03 03 02 02 19 19 19 02 02 02 02 02 19 
19 10 05 05 05 05 06 07 07 07 17 02 02 02 02 02 02 02 02 02 02 02 02 02 02 02 02 02 02 02 02 02 02 02 19 19 19 02 03 03 02 02 02 02 02 02 02 02 02 19 
19 10 05 06 07 07 17 02 02 02 02 02 02 02 02 02 03 02 02 02 03 03 03 02 02 02 02 02 02 02 02 02 02 02 19 02 19 19 02 03 02 19 19 19 19 02 03 03 02 19 
19 16 07 17 02 02 02 02 02 02 02 02 02 02 02 03 03 02 02 02 02 02 03 03 03 19 19 19 19 02 02 02 02 02 02 19 02 19 02 02 02 02 02 19 19 02 02 02 02 19 
19 02 02 19 02 02 02 03 02 02 02 02 02 03 03 02 02 02 02 02 02 02 02 02 02 02 02 02 19 19 19 19 02 02 02 19 19 19 19 02 02 02 19 19 02 02 02 02 19 19 
19 02 02 02 02 02 02 03 02 19 02 02 02 02 02 02 02 02 19 02 02 02 03 02 02 02 02 02 02 02 02 19 19 19 02 02 19 19 19 02 02 02 19 02 19 19 19 19 19 19 
19 02 02 02 02 02 02 02 19 19 02 02 02 02 02 02 02 19 19 02 02 02 03 02 02 02 02 02 02 02 02 02 02 19 19 02 02 02 02 02 02 02 19 19 02 02 02 19 19 23 
19 02 02 02 02 02 02 02 02 02 02 02 02 02 02 02 02 02 02 02 02 02 02 02 02 02 02 02 02 02 02 02 02 02 19 19 02 02 02 02 03 03 02 19 19 02 02 19 02 26 
19 02 02 02 19 02 02 02 02 02 02 02 19 02 02 02 02 02 02 02 02 02 02 02 02 02 02 02 02 02 03 02 02 02 02 02 02 02 02 02 02 03 02 02 19 19 02 19 23 34 
19 19 02 02 02 02 02 02 02 02 02 02 19 02 02 02 02 02 02 02 02 02 03 03 02 02 02 02 02 02 03 02 02 02 02 02 02 02 02 02 02 02 02 02 02 02 19 23 34 21 
19 19 02 02 02 02 03 02 02 02 02 02 02 02 02 02 02 02 02 19 02 02 02 02 02 02 19 19 02 02 02 03 02 02 02 02 02 19 02 02 02 02 02 02 02 02 23 34 22 21 
19 19 02 02 02 02 03 03 02 02 02 02 02 02 03 02 02 02 02 02 02 02 02 02 02 02 02 02 02 02 02 02 02 02 02 02 02 02 02 02 02 02 02 02 02 23 34 21 21 21 
19 19 02 03 02 02 02 03 03 02 02 02 02 02 03 02 02 02 02 02 02 02 02 02 02 02 02 02 02 02 02 02 02 02 02 02 02 02 02 02 02 02 02 23 24 34 21 21 21 21 
19 19 02 03 03 02 02 02 02 02 02 02 02 02 02 02 02 02 02 19 19 19 19 02 19 02 02 19 02 19 02 02 02 02 02 02 02 02 02 23 24 24 24 34 21 21 21 21 22 21 
19 19 02 03 03 02 19 19 19 19 19 19 19 19 19 19 19 19 19 19 19 02 02 19 19 02 19 19 19 19 02 02 02 02 23 24 24 24 24 34 21 21 21 21 21 21 21 21 21 21 
19 19 02 02 02 02 19 19 19 19 19 19 19 19 19 19 02 02 19 19 19 02 19 19 19 19 19 02 19 19 02 02 02 23 34 22 21 21 21 22 21 21 21 21 21 21 21 21 21 21 
19 19 19 19 19 19 19 19 19 19 19 19 19 19 19 19 19 19 19 19 19 19 19 19 19 19 19 19 19 19 02 02 23 34 21 21 21 21 21 21 21 21 21 21 22 21 21 21 21 21 
19 19 19 19 19 19 19 19 19 19 19 02 19 19 19 19 19 19 19 19 19 02 19 19 19 19 19 19 19 19 23 24 34 22 21 21 21 21 21 21 21 21 21 21 21 21 21 21 21 21 
